;= alias
fa=doskey /macros | findstr /i $1
la=doskey /macros
re=doskey /macrofile=%doskey%

;= notepad
n=notepad $1

;= dos commands
sb=dir /s/b $*
findh=%envDir%find.bat . $1 $2
findv=findstr /slinp /C:"$*" *
find=findstr /slimp /C:"$*" *
kill=taskkill /f /im $*

;= root dirs
c=pushd c:\
f=pushd f:\

;= pushd
pd=pushd $*
.=pushd ..
..=pushd ..\..
...=pushd ..\..\..
....=pushd ..\..\..\..
.....=pushd ..\..\..\..\..

;= popd
p=popd
pp=popd && popd
ppp=popd && popd && popd
pppp=popd && popd && popd && popd
ppppp=popd && popd && popd && popd && popd

;= git
gs=git status
ga=git add .
gc=git commit -m $*
gl=git log -1 $1
nuke=git clean -fdXq
scorch=git clean -fdXq -e !dls

;= idProj
build-id=msbuild %idProj% /v:m

;= publishProj
build-publish=msbuild %publishProj% /v:m
build-publish-force=msbuild %publishProj% /v:m /p:IsEnlistmentClean=true

;= shimProj
shim=msbuild %shimProj% /t:dumpProjects
restore=msbuild %shimProj% /v:m /t:nugetRestore

dryRun=msbuild %shimProj% /v:m /t:dryRun /p:Configuration="debug;release" /p:ShimProperties="$*"
dryRun-debug=msbuild %shimProj% /v:m /t:dryRun /p:Configuration="debug" /p:ShimProperties="$*"
dryRun-release=msbuild %shimProj% /v:m /t:dryRun /p:Configuration="release" /p:ShimProperties="$*"

rebuild=msbuild %shimProj% /v:m /t:rebuild /p:Configuration="debug;release" /p:ShimProperties="$*"
rebuild-debug=msbuild %shimProj% /v:m /t:rebuild /p:Configuration="debug" /p:ShimProperties="$*"
rebuild-release=msbuild %shimProj% /v:m /t:rebuild /p:Configuration="release" /p:ShimProperties="$*"

build=msbuild %shimProj% /v:m /t:build /p:Configuration="debug;release" /p:ShimProperties="$*"
build-debug=msbuild %shimProj% /v:m /t:build /p:Configuration="debug" /p:ShimProperties="$*"
build-release=msbuild %shimProj% /v:m /t:build /p:Configuration="release" /p:ShimProperties="$*"

clean=msbuild %shimProj% /v:m /t:clean /p:Configuration="debug;release" /p:ShimProperties="$*"
clean-debug=msbuild %shimProj% /v:m /t:clean /p:Configuration="debug" /p:ShimProperties="$*"
clean-release=msbuild %shimProj% /v:m /t:clean /p:Configuration="release" /p:ShimProperties="$*"

;= link
linkdir=mklink /j $1 $2
diruse=subst $1 $2

;= pushd
r=pushd %RootDir%
src=pushd %SrcDir%
bin=pushd %BuildBinDir%
obj=pushd %BuildTempDir%
bld=pushd %BuildDir%
dls=pushd %DlsDir%
ext=pushd %MxbuildDir%
drp=pushd %DropDir%
pkg=pushd %PkgDir%
tools=pushd %ToolsDir%

;= todo
todo=echo $* >> %RootDir%todo.txt
ltodo=type %RootDir%todo.txt
ntodo=notepad %RootDir%todo.txt